NO FPStextures/FPS64x/Texture0.png
WE FPStextures/FPS64x/Texture1.png
EA FPStextures/FPS64x/Texture2.png
SO FPStextures/FPS64x/Texture2.png

C 35,19,73
F 15,6,40

111111111111111
111111000111111
111110000011111
11110000001111111111111111110
111000000000111
110000000000011
1000011111000011
110000111000011
111000010000111
111111111111111
111111101111111
111100000001111
111110000011111
1111110N0111111
111111111111111