1234




1111
10N11
111011111111111111111111111111111111111111111111111111111111111

1  111 111111111111111111                                     11111
111111111111111111111111111111111111111111111111111111111111111
