12341

    
   

1111
10N11
111011



111111111111111111111111111111111111111111111111111111111

1  111 11111111111111111N                                     11111
111111111111111111111111011111111111111111111111111111111111111


  11101
1111111
1010001
1010111
111  11

111111
101001010
11111
