NO FPStextures/FPS64x/Texture0.png
WE FPStextures/FPS64x/Texture1.png
EA FPStextures/FPS64x/Texture2.png
SO FPStextures/FPS64x/Texture3.png



F  1   ,    255,    01 
C    2 ,   3  3    ,                                              



        111111111111111111111111
        1000000000110000000000001
        101100000111000000000000111
        1001000000000000000000001
111111111011000001110000000000001
100000000011000001110111111111111
11110111111111011100000010001
11110111111111011101010010001
11000000110101011100000010001
10000000000000001100000010001
100000000000000001101010000001
11000001110101011111011110E0111
11110111 1110101 101111010001
11111111 1111111 111111111111