NO textures/1.xpm
SO textures/2.xpm
WE textures/3.xpm
VV
EAtextures/4.xpm
F5,    250,     0      
C         115,   111,   99     

        1111111111111111111111111
        100000000011000000000000111111111111111111111111111111111111111111111111111111111111111111111111111111111111111111111111111111111111111111111111111
        1011000001110000000000001
        1001000000000000000000001
111111111011000001110000000000001
10000000001100000111011111 1111111
11110111111111011100000010 001
11110111111111011101010010 001
11000000110101011100000010 001
10000000000000001100000010 001
10000000000000001101010000 001
11000001110101011111011110N0111
11110111 1110101 101111010001
11111111 1111111 1111111111111
1111111111111
1111111111111
1111111111111
1111111111111
1111111111111
1111111111111
1111111111111
1111111111111
1111111111111
1111111111111
1111111111111
1111111111111
1111111111111
1111111111111
1111111111111
1111111111111
1111111111111
1111111111111
1111111111111
1111111111111
1111111111111
1111111111111
1111111111111
1111111111111
1111111111111
1111111111111
1111111111111
1111111111111
1111111111111
1111111111111
1111111111111
1111111111111
1111111111111
1111111111111
1111111111111
1111111111111
1111111111111
1111111111111
1111111111111
1111111111111
1111111111111
1111111111111