1234




1111
10N1
1111

a 
111
1N1
11
   
     


