111111111
110000001 
111110001
111000001 
100000001
111111111